█████████████████████████████████████████████████
██      ██     ██                              ██
██      ██     ██               ██             ██
██      ██     ██               ██             ██
██      ██     █████████████    ██             ██
██                              ██             ██
██                                             ██
██      ████       █████████    ██             ██
██      ██                ██    ██             ██
██      ██                ██    ██             ██
██      ██                ██    ██             ██
██      ██     ██         ██    █████████████████
██             ██                   ██         ██
██      ██     ██         ██                   ██
██      ██     ██         ██    █████████████████
██      ██     ██         ██    ██             ██
██      ██     ██         ██    ██             ██
██      ██     ██         ██    ██             ██
██             ██                              ██
█████████████████████████████████████████████████