                                                            █████████████████████████████████████████████████
                                                            ██      ██     ██                              ██
                                                            ██      ██                      ██             ██
                                                            ██             ██               ██             ██
                                                            ██      ██     ██████  █████    ██             ██
                                                            ██                              ██             ██
                                                            ██                                             ██
                                                            ██      ████       █████████    ██             ██
                                                            ██                        ██    ██             ██
                                                            ██      ██                      ██             ██
                                                            ██      ██                ██    ██             ██
                                                            ██      ██     ██         ██    ██████████  █████
                                                            ██             ██                   ██         ██
                                                            ██      ██     ██         ██                   ██
                                                            ██      ██                ██    ███████  ████████
                                                            ██      ██     ██         ██    ██             ██
                                                            ██      ██     ██         ██    ██             ██
                                                            ██      ██     ██         ██    ██             ██
                                                            ██             ██                              ██
                                                            █████████████████████████████████████████████████